SUAI	.ASC		;Stanford AI character set and meanings SAIL/text
GOGTAB	.DEC		;Decimal output from GOGTAB.SAI
APPNDX	.DOC		;additions section of manual
CHANGE	.DOC		;Changes made/detected during the "MERGE"
CKS	.DOC		;Document for CKS (SAIL-language CKSUM)
FAIL	.DOC		;FAIL document
GOGTAB	.DOC		;One-line descriptions of GOGTAB entries
NEWSAI	.DOC		;"How to build SAIL" (the rudder)
RUNTIM	.DOC		;Output from IFOO2/IFOO3 = descriptions of runtimes
SAIL20	.DOC		;SAIL addendum for t-20 users
SEMBLK	.DOC	INDOC	;Layout of SEMBLKs w/in compiler
TUTX	.DOC		;Compiled TUTX.PUB
LINK	.FIX		;Fixes needed to make LINK-10 POLISH work
SAIL	.INF		;information about SAIL changes -- TYMSHARE
FAIL	.INS		;How to build FAIL
ACCESS	.LIS		;TYMCOM-X standard file
FAIL	.MAN		;FAIL document (user)
GOGTAB	.OCT		;Octal output from GOGTAB.SAI
ALDECL	.PUB	MAN	;ALGOL DECLARATIONS
ALEXPR	.PUB	MAN	;ALGOL EXPRESSIONS
ALSTAT	.PUB	MAN	;ALGOL STATEMENTS
APPEND	.PUB	MAN	;APPENDICES
ASSTAT	.PUB	MAN	;ASSEMBLY LANGUAGE STATEMENTS
BACKTR	.PUB	MAN	;BACKTRACKING
BAILEX	.PUB	MAN	;BAIL EXAMPLE
BASIC	.PUB	MAN	;BASIC CONSTRUCTS AND USING SAIL
BNFTST	.PUB	MAN	;PUB THIS TO CHECK ON BNF/GROUP/PAGE BOUNDARY ALIGNMENT
C10BNF	.PUB		;BNF for corresponding chapter
C11BNF	.PUB		;BNF for corresponding chapter
C12BNF	.PUB		;BNF for corresponding chapter
C13BNF	.PUB		;BNF for corresponding chapter
C14BNF	.PUB		;BNF for corresponding chapter
C15BNF	.PUB		;BNF for corresponding chapter
CH1BNF	.PUB		;BNF for corresponding chapter
CH2BNF	.PUB		;BNF for corresponding chapter
CH3BNF	.PUB		;BNF for corresponding chapter
CH4BNF	.PUB		;BNF for corresponding chapter
CH5BNF	.PUB		;BNF for corresponding chapter
CH6BNF	.PUB		;BNF for corresponding chapter
CH9BNF	.PUB		;BNF for corresponding chapter
COVER	.PUB	MAN	;SEPARATE RUN FOR COVER
DEBUG	.PUB	MAN	;DEBUGGING
DOC	.PUB	MAN	;MAIN RUN IS: PUB DOC(X)
EVENTS	.PUB	MAN	;EVENTS
EX	.PUB	MAN	;EXECUTION-TIME ROUTINES
INTERP	.PUB	MAN	;INTERRUPTS
INTINX	.PUB	MAN	;SYMBOLIC NAMES FOR INTERRUPT BITS
IO	.PUB	MAN	;INPUT/OUTPUT
IOSER	.PUB		;Document for TENEX-SAIL IOSER changes (user-READ)
KOUNT	.PUB	MAN	;STATEMENT COUNTERS
LEAP	.PUB	MAN	;LEAP
LPRUNT	.PUB	MAN	;LEAP AND PROCESS RUNTIMES
MACRO	.PUB	MAN	;MACROS AND CONDITIONAL COMPILATION
OPEN	.PUB	MAN	;EXAMPLE OF TOPS-10 I/O
PREF	.PUB	MAN	;PREFACE
PRGBLK	.PUB	MAN	;PROGRAMS AND BLOCKS
PRINT	.PUB	MAN	;PRINT
PROCAP	.PUB	MAN	;APPENDIX ON PROCEDURE IMPLEMENTATION
PROCES	.PUB	MAN	;PROCESSES
PROVAR	.PUB	MAN	;PROCEDURE VARIABLES (APPLY)
RECORD	.PUB	MAN	;RECORDS AND REFERENCES
REFER	.PUB	MAN	;REFERENCES
SAIL	.PUB	UPD	;UPDATE MANUAL THAT WAS MERGED IN
TC	.PUB	MAN	;SEPARATE RUN FOR TABLE OF CONTENTS
TENEX	.PUB	MAN	;TENEX ROUTINES
TEST	.PUB	DEBUG	;TEST
TITL	.PUB		;Title page for SAIL manual extensions
TITLE	.PUB	KVL	;OLD TITLE PAGE
TRIPLE	.PUB	MAN	;MATCHING PROCEDURE EXAMPLE
TUTOR	.PUB		;LEAP TUTORIAL -- Jim Low  [SUAI sources]
TUTX	.PUB		;LEAP TUTORIAL -- Jim Low [conversion start]
XTENDX	.PUB		;SAIL addendum -- needs PUBMAC
CHARIT	.SAI		;Substitutes for SUAI characters (over-general)
GOGTAB	.SAI		;Creates numeric document of GOGTAB entries
IFOO3	.SAI		;Program to convert FOO3 to "text" descriptions
IFOO3	.SAV		;Program to convert FOO3 to "text" descriptions
COVER	.		;Cover letter for SAILSHIP-3 (v23A-5)
